1111111111111111
100001000000E001
1000011100000001
10000C00001P0001
1111111111111111