1111111111111111
100001000000E001
10000111000P0001
10000C0000100001
1111111111111111