1111111111111111
100000000000E001
10000000000P0001
10000C0000000001
1111111111111111