1111111111111
1CCCCCCCCCCC1
1CCCCCCCCCCC1
1CCCCCCCCCCC1
1CCCECCCCCCC1
1CCCCCCPCCCC1
1111111111111