1111111111111111111111111111111111111
1P000000000100000000000000000000000C1
1000000010C10000000000000000000000001
1000000011110000000000000000000000001
1000000000000000000000000000000000001
1000000000000000000111111111111111101
1000000000000000000100000C0000C000001
1000000000000000000100000000000000001
100000000000000000010000000000C00C0E1
1111111111111111111111111111111111111