111111111111111111111111111111
10000000000000000000000000001
11111111111111111111111111111
111111111111111111111111111111
1101
1111